5 5
7 9 8 9 7
6 9 1 3 2
8 5 3 6 6
9 7 2 8 7
6 1 4 2 6
0 0 0
4 4 0
