5 5
6 4 7 9 9
1 5 8 4 9
8 3 3 9 8
7 8 1 1 3
8 4 1 5 6
0 0 0
4 4 4
