5 5
7 7 1 2 2
9 6 2 2 7
1 9 7 2 9
7 1 6 5 8
1 9 6 7 6
0 0 0
4 4 0
