5 5
3 7 2 3 6
4 2 1 9 7
9 5 3 5 7
6 3 9 6 9
2 3 7 7 1
0 0 0
4 4 2
