5 5
8 1 6 8 8
5 7 1 3 9
6 9 9 9 3
6 9 2 9 6
4 6 2 5 9
0 0 0
4 4 3
