7 7
4 6 5 7 1 9 2
4 9 4 1 4 5 4
2 6 2 6 9 9 3
9 3 8 8 7 1 5
8 6 7 4 9 3 1
8 6 2 1 6 8 6
7 6 6 4 8 6 4
0 0 0
6 6 2
