7 7
7 1 7 7 9 5 3
9 7 6 2 5 2 5
9 6 1 7 1 7 5
2 8 6 4 8 5 8
6 4 8 9 5 6 1
3 2 1 7 8 3 8
9 1 8 9 3 6 6
0 0 0
6 6 3
