7 7
1 8 9 5 1 6 7
4 2 5 5 3 7 6
7 1 1 8 3 4 1
5 9 3 9 4 5 8
8 4 5 9 2 2 8
9 9 5 4 9 2 7
7 8 2 1 7 7 9
0 0 0
6 6 5
