7 7
3 8 3 4 4 4 1
4 4 2 7 1 1 7
6 9 1 1 4 7 5
3 5 2 5 6 4 9
1 6 3 8 4 7 4
9 7 7 9 4 7 2
8 1 5 3 8 2 3
0 0 0
6 6 1
