7 7
8 6 9 1 8 9 6
5 6 4 7 1 2 9
2 6 2 4 7 3 7
3 8 3 1 3 2 6
1 2 3 4 8 7 4
7 1 1 3 2 8 2
3 1 6 8 4 4 4
0 0 0
6 6 6
