9 9
6 3 2 1 5 6 7 6 4
1 1 9 2 2 4 5 4 3
9 1 9 5 7 9 6 6 3
7 1 5 6 6 1 6 9 1
5 2 7 3 6 8 2 9 4
7 2 4 4 6 7 8 5 9
9 3 7 1 5 1 3 4 6
3 2 3 2 5 2 2 6 1
5 6 3 5 7 2 5 9 9
0 0 0
8 8 1
