9 9
9 2 6 5 5 8 4 1 2
2 2 8 7 6 3 3 7 1
7 4 4 1 7 3 2 3 9
5 7 3 7 5 2 1 2 7
5 1 9 4 5 5 9 6 1
3 5 5 4 7 4 8 1 7
2 3 3 1 9 4 2 8 4
7 7 9 6 2 4 2 8 1
9 5 1 4 1 3 9 2 1
0 0 0
8 8 6
