9 9
8 7 6 3 7 7 2 2 1
4 3 3 5 6 9 7 5 5
7 3 9 9 9 2 1 3 9
2 8 4 9 8 1 6 5 8
6 5 9 6 4 3 1 6 1
2 8 6 7 3 2 2 4 7
3 9 2 8 9 4 9 8 6
6 7 5 6 8 3 4 2 1
9 3 6 1 3 3 3 7 3
0 0 0
8 8 8
