9 9
4 9 3 8 9 1 8 3 5
6 9 8 4 2 7 8 7 6
1 7 7 2 6 8 8 1 2
1 6 6 6 4 9 9 8 6
4 1 3 3 8 4 8 7 1
6 3 5 6 9 5 2 6 4
1 2 9 3 9 1 8 9 7
7 8 2 4 3 6 4 6 7
8 2 7 2 6 9 7 2 4
0 0 0
8 8 4
