9 9
2 2 6 3 4 2 2 7 8
7 8 1 7 1 2 5 9 7
7 6 6 6 2 6 3 2 1
8 7 9 6 1 4 5 6 5
3 6 8 6 4 9 1 8 3
4 6 4 8 9 4 5 3 4
8 8 6 8 8 8 5 7 5
2 7 8 2 6 7 9 3 4
1 3 7 9 8 5 4 5 3
0 0 0
8 8 8
